10,10,2
5,8,0
8,5,1

0011100111
1111011110
0111100101
0001001010
1000100110
0110010001
1100111010
1100100111
0011101000
1110111100

1110011010
1001011011
0011011100
0101010001
0110111000
0000110100
1100010101
1100001101
1101110001
1100110111


